............
##########f#
#..........#
#.##########
#.....#
#####.######
#..........#
##########.#
#........#.#
#........#.#
#.###...##.#
#.####@###.#
######.###.#
#..........#
############