####....#.......#####
###..##...##..#..####
##..####.#######..###
#..##############..##
#.################.##
..################..#
@##################f#