###...###
#.......#
#.......#
.........
.........
....@....
#.......#
#.......#
###...###